Структура SQL-запроса


Последовательность выполнения операций на сервере:

MySQL: FROM => WHERE = SELECT = GROUP BY = HAVING = ORDER BY = LIMIT.   

PostgreSQL: FROM => WHERE = GROUP BY = HAVING = SELECT = DISTINCT = ORDER BY = LIMIT.



AS - "в качестве": левый операнд AS(в качестве) правого операнда, можно также перевести как "обзови всё что слева фразой справа"

CASE - нет, это не кейс, но этимология таже, чемодан так называют потому что ему подобные брали на всякий СЛУЧАЙ, 
в данном контексте это слово стоит понимать как "В СЛУЧАЕ"

WHEN - продолжим про случай, переводится как "КОГДА"

THEN - вот именно "ТОГДА"

ELSE - буквально переводится как "В ПРОЧЕМ" или "В ОСТАЛЬНЫХ СЛУЧАЯХ"

END - конец, амба, приехали, заканчивай съёмку

SELECT - кто не играл в Денди/Сегу? В данном случае употребляется в повелительном наклонении - приказ СУБД выбрать что-то

FROM - да-да как вы догадалсь уже наверное - "ИЗ" чего-то (или отобрать у кого-то, наше дело маленькое - сказать, а у кого СУБД отбирать будет... Проблемы индейцев шерифов не ... волнуют)

JOIN - Наслаждайся!!! Конечно первое, и в данном случае - правильное значение этого слова: присоединяйся!
`Даша` (INNER)JOIN `Петя` - сегодня они встречаются в ресторанчике как-раз на пол пути от Пети к Даше
`Даша` LEFT(INNER) JOIN `Петя` - Петя пошёл налево, но не на грядки, а - к Даше, причём в данном случае - домой к Даше.
Ну а если `Даша` RIGHT(INNER) JOIN `Петя` - то, видимо Даша не дождалась Петю и пошла к нему сама (разумеется - не налево).

`Даша` LEFT OUTER JOIN `Петя` - Петя пришёл во двор к Даше, и Даша вышла туда-же(причём - оба со всеми своими пожитками-нажитками, видимо, куда-то собрались).
`Даша` CROSS JOIN `Петя` - м-м-м... дайте ка подумать... А-а-а... Петя с Дашей переехали в другую квартиру(или дом) и наплодили много маленьких Петь и Даш всех возможных вариантов сочетания Пети с Дашей(надеюсь - не слишком пошло)
WHERE - "Где-где...? - В Караганде... которая находится в РФ" или "в гнезде в котором именно 2 яйца, а не 3-5-6", кому как нравится...

BY - не путайте с "BYE", а то - пошлёт вас СУБД в ту самую баню... Не знаю как другим, но мне большинство проблем "BY"-барабану, я - заядлый оптимист =D

ну а дальше ничего особо сложного и нет:
GROUP - в данном случае скорее глагол: СГРУППИРУЙ то, да сё...
HAVING - имеющих 3 головы AND 5 хвостов
ORDER - в каждом доме должен быть, а в голове и подавно(плохо, когда там каша-малаша)!!! ;)
PARTITION - раздел, в данном случае - не глагол!!! Существительное - "разделение", "разграничение".
UNION - это когда Иа вернули хвост... получился UNION ослика и его хвостика =)

Как же я мог забыть про оператор - OVER:
применяется к оконным фнкциям, указывая им в каких "PARTITION BY"-йнах задуманное вершить, и в каком "ORDER BY" тамошних("PARTITION BY"-йных) прихожан обслуживать...
Первым значением слова является наречие "через", в данном контексте - "вот там, по всей 'PARTITION BY'-йной местности"

LIKE - "I like to move it - move it..." Нет, это не лайк, ну, во всяком случае - не в том смысле в котором вы могли бы подумать... 'Даша' LIKE 'Петя' не значит что Даше нравится Петя, в даном случае это предлог "как" или причастие "похож", то биш,- разве что только количеством букв в имени. В языке SQL обзывается паттерном(шаблоном)
BETWEEN - один шаг BETWEEN любовь AND ненависть

PRIMARY - помните такого: Пётр PRIME? Переводится как "первичный", имеется в виду - "KEY", эта парочка слов творит магию СУБД определяя золотой ключик. Но, стоит заметить что это не единственный магический артефакт, есть ещё один - FOREIGN, тоже - ключик. Эти ключи - истинная сила RELATION-ной модели базы данных, именно они и творят чудеса слияния головы, хвоста и ног в нечто большее и прекрасное. Relation - переводится как "отношение" чего-то к чему-то, либо как "связь" чего-то с чем-то(кого-то с кем-то - тоже).

UPDATE - сокращение от "Up to date", дословно переводится как "поднято до даты(последней)", только в контексте SQL это - глагол, который говорит базе - Обнови!

SET - нет, это не про восточную кухню, это глагол - установи

INSERT - это из оперы про: запихни, впихни, воткни INTO-дато =D

DELETE - интересное слово: ДЕЛЕТЕ... Как вспомню знакомство мамы с компуктером... Слово "ДЕЛЕТЕ" - глагол "удали" в исключительно повелительном наклонении.

DROP - О-о-о-о, вот мы и добрались до самого интересного... Никогда, Вы слышыте меня? Никогда не бросайте каку!!! На время работы с БД забудьте чему вас учили родители по данному поводу в детстве... Каку можно и поднять, а вот TABLE который по идее - нечто "Таблетное", например: таблица(а может и TAB чьего-то лица, ибо "Tab" - нарицательное обозначающее некую ровную поверхность прямоугольной формы), или что ещё хуже - DATABASE, уйдут в небытие, сразу и не замедлительно!!! Это относится и к мегаинтересному слову "ДЕЛЕТЕ", с небольшой оговоркой...